   NO  ./path_to_1_north_texture
SO ./path_to_the_west_texture
WE        ./path_to_the_west_texture
EA     ./path_to_the_east_texture





C    225,30,0
F        220,16,2


1111111111111111111111
1000000000000000000001
1000000000000000000001
100000000000000111111
1000000000000000000001
100000000000000000001
100000000W000000000001
1000000000000000000001
1000000000000000000001
1111111111111111111111