   NO  ./path_to_1_north_texture
SO ./path_to_the_west_texture
WE        ./path_to_the_west_texture
EA     ./path_to_the_east_texture





C    225,30,0
F        220,16,12


11111111111111111111111111111111
1111111110000000000000000011111
11111111111100000000000000000001
1111111111111111111111111111
11111111111100000000000000001111
1111111111111000000000000000001
11111  1111111000000000000000001
1111111111111000000000000000011
11111111111100000N0000000000011
1111111111111000000000000000011
1111111111110000000000000000001
1111111111110000000000000000111
1111111111110000000000000000011
11111111111100000011100000000011
1111111111111111111 111111111111
